2 8 2095 81 4265 4253 2006 779 2493 4252 
3 7 277 4327 2017 4374 2055 4379 4357 
2 3 4446 2241 2017 
1 14 4938 753 5002 5008 5033 5058 5085 1245 5129 5157 841 5233 2481 377 
1 11 2736 873 2568 4641 4673 545 4698 23 2071 4807 6410 
1 8 4977 4964 4943 1307 2370 312 4848 4834 
1 7 5157 1925 5206 2564 5185 1570 53 
1 4 1269 2153 5126 1570 
1 3 5157 5164 1263 
1 8 4962 4978 4988 2239 2539 5053 2156 1269 
1 5 4977 2171 323 5142 223 
